{
    "title":"TestMap2",
    "Author":"Unkoman",
    "other":"null",
    "stagesize":"Normal",
    "mapData":[
            [8,8,8,8,8,8,8,8,8,8,8],
            [8,0,0,0,0,0,0,0,0,0,8],
            [8,0,1,0,3,4,0,0,0,0,8],
            [8,0,0,0,0,0,8,0,0,0,8],
            [8,0,0,0,0,0,0,0,0,0,8],
            [8,0,0,0,0,0,0,0,0,0,8],
            [8,8,8,8,8,8,8,8,8,8,8]
    ]
}