{
    "title":"動作検証用",
    "Author":"PuzzleGame",
    "other":"動作テスト用",
    "stagesize":"Normal",
    "mapData":[
            [8,8,8,8,8,8,8,8,8,8,8],
            [8,0,0,0,0,0,0,0,0,0,8],
            [8,0,1,0,0,0,0,0,0,0,8],
            [8,0,0,0,0,0,0,0,0,0,8],
            [8,0,0,0,0,0,0,0,0,0,8],
            [8,0,0,0,0,0,0,0,0,0,8],
            [8,8,8,8,8,8,8,8,8,8,8]
    ]
}