{
    "title":"チュートリアル",
    "Author":"情報処理部",
    "other":"ドラッグアンドドロップ",
    "stagesize":"Normal",
    "mapData":[
            [0,0,0,0,0,8,0,0,0,0,0],
            [0,0,0,0,0,8,0,0,0,0,0],
            [0,0,0,0,0,8,0,0,0,0,0],
            [0,1,0,0,0,0,0,0,0,4,0],
            [0,0,0,0,0,8,0,0,0,0,0],
            [0,0,0,0,0,8,0,0,0,0,0],
            [0,0,0,0,0,8,0,0,0,0,0]
    ]
}