
{
    "title":"チュートリアル5",
    "Author":"情報処理部",
    "other":"切り離し",
    "stagesize":"Normal",
    "mapData":[
            [0,0,0,8,0,0,0,0,0,0,0],
            [0,0,0,8,0,0,4,0,0,0,0],
            [0,0,0,8,0,0,1,0,0,0,0],
            [0,3,0,0,0,0,0,0,0,0,0],
            [0,0,0,8,0,0,0,0,0,7,0],
            [0,0,0,8,0,0,0,0,0,0,0],
            [0,0,0,8,0,0,0,0,0,0,0]
    ]
}