
{
    "title":"チュートリアル6",
    "Author":"情報処理部",
    "other":"切り離し2",
    "stagesize":"Normal",
    "mapData":[
            [0,0,0,8,0,0,0,8,8,8,8],
            [0,0,0,8,0,0,0,0,0,0,0],
            [0,0,0,8,4,0,0,0,0,0,0],
            [0,0,0,0,0,0,0,8,8,0,8],
            [0,0,0,8,0,0,0,8,8,0,8],
            [0,1,0,8,0,7,0,8,8,3,8],
            [0,0,0,8,0,0,0,8,8,8,8]
    ]
}