{
    "title":"チュートリアル4",
    "Author":"情報処理部",
    "other":"固定２",
    "stagesize":"Normal",
    "mapData":[
            [0,0,0,8,8,8,8,8,0,0,0],
            [0,0,0,8,8,8,8,8,0,0,0],
            [0,0,0,0,0,0,0,0,0,0,0],
            [0,0,0,8,5,8,8,8,0,4,0],
            [0,0,0,0,0,0,0,0,0,4,0],
            [0,1,0,8,8,6,8,8,0,0,0],
            [0,0,0,8,8,8,8,8,0,0,0]
    ]
}